10
00 00 00 00 00 00 00 00 05 05 
00 00 00 00 00 00 00 00 00 05 
00 00 00 00 00 00 11 15 15 00 
00 00 00 00 00 03 00 00 00 00 
00 00 00 00 00 00 00 00 00 05 
05 00 00 00 04 00 07 00 00 00 
05 00 00 00 00 00 00 00 00 00 
05 05 00 00 00 00 00 00 01 00 
05 05 00 00 00 00 00 00 00 00 
05 05 00 00 06 00 00 00 00 00 
