00 00 00 00 00 05 05 05 05 05 
00 00 00 00 00 00 00 05 05 00 
00 00 00 00 00 00 00 05 00 00 
00 00 00 00 00 00 00 00 00 00 
00 00 00 00 00 00 00 00 00 00 
00 00 00 10 11 12 13 00 00 00 
00 00 00 00 00 00 00 00 00 00 
00 00 00 00 17 14 00 01 00 00 
00 00 00 00 00 00 00 00 00 00 
00 00 09 09 00 00 00 00 00 00 
