7
00 00 00 00 36 48 42 
00 00 00 00 00 36 34 
00 00 03 03 03 03 26 
00 00 00 06 00 03 26 
00 00 00 00 21 29 23 
00 00 00 00 28 03 01 
00 00 00 00 24 00 00 
