7
05 05 05 00 45 40 42 
05 00 00 00 36 44 34 
00 03 03 03 03 03 26 
00 00 06 00 21 31 23 
00 00 07 00 26 03 00 
00 00 00 00 28 00 01 
00 00 00 00 00 00 00 
