7
00 01 00 00 16 00 00 
00 00 00 00 16 00 00 
36 28 03 00 16 00 00 
09 23 21 17 13 00 00 
09 37 03 00 00 00 00 
34 29 03 03 03 03 05 
04 06 00 05 05 05 05 
