7
05 05 05 00 36 48 42 
05 05 00 00 00 36 34 
05 05 03 03 03 03 26 
05 00 00 06 00 03 26 
04 00 00 00 21 29 23 
00 00 05 00 28 03 01 
00 04 05 05 24 00 00 
